


NO ./assets/sprites/club.xpm
SO ./assets/sprites/club2.xpm

WE ./assets/sprites/club3.xpm
EA ./assets/sprites/club.xpm



F 155,48,255
C 15,48,255


            1111111111111111111111111
            1000000000110000000000001
            1011000001110000000000001
            1000100000000000000000001
111111111111000001110000000000011111
1000000000110000011101110000111111111
1111011111111101110000001000111
11110111111111110011101010010001
1000000011010100110000001001111
10000000000000001100000010001
10000000000000001100000010001
10000000000000001100000010001
100000000010000011000000010001
1000N000010100001100000010001
10000000001000001101010110111
10000000000000001101010110111
10000000000000001101010110111
10000000000000001101110110111
1000000111010101111101111000111
11110111 1110101 101111010001
11111111 1111111 111111111111