


          NO ./assets/sprites/north.xpm
SO ./assets/sprites/south.xpm

WE ./assets/sprites/west.xpm

EA ./assets/sprites/east.xpm


F 220,100,0
C 220,30,0


            1111111111111111111111111
            110000000000000110000001
            1 1111111110011111111111
            1 111111111111111N111111