


NO ./assets/sprites/north.xpm
SO ./assets/sprites/south.xpm

WE ./assets/sprites/west.xpm

EA ./assets/sprites/east.xpm


F 34,139,34
C 135,206,235


            1111111111111111111111111
            1000000000110000000000001
            1011000001110000000000001
            1000100000000000000000001
1111111111110000011100000N00000011111
1000000000110000011101110000111111111
11110111111111011100000010001
11110111111 1 111011101010010001
11000000110101011100000010001
10000000000000001100000010001
10000000000000001101010110001
1100000111010101111101111000111
11110111 1110101 101111010001
11111111 1111111 111111111111