


NO ./assets/sprites/north.xpm
SO ./assets/sprites/south.xpm

WE ./assets/sprites/west.xpm
EA ./assets/sprites/east.xpm



F 155,48,255
C 20,10,10


            1111111111111111111111111
            1000000000110000000000001
            1011000001110000000000001
            1000100000000000000000001
111111111111000001110000000000011111
1000000000110000011101110000111111111
1111011111111101110000001000111
11110111111111111011101010010001
1000000011010101110000001001111
10000000000000001100000010001
10000000000000001100000010001
10000000000000001100000010001
1000000000100000110000N0010001
10000000010100001100000010001
10000000001000001101010110111
10000000000000001101010110111
10000000000000001101010110111
10000000000000001101110110111
1000000111010101111101111000111
11110111 1110101 101111010001
11111111 1111111 111111111111