


NO ./assets/sprites/north.xpm
SO ./assets/sprites/south.xpm


WE	./assets/sprites/west.xpm
EA ./assets/sprites/east.xpm


F 220,100,0
C 220,30,0


            1111111111111111111111111
            1000000000000000000000001
            1111111111111111111111111
			1000000000110000000000001
            1011000001110000000000001
            1001000000000000000000001
1111111111111011000001110000000000001
1111100000000011000001110111111111111
11110111111111011100000100011
11110111111111011101010010001
11000000110101011100000010001
10000000000000001100000010001
100000000000000011010100100011
11000001110101010111011110N01011
11110111 1110101 1011110100001
11111111 1111111 111111111111