NO ./assets/sprites/north.xpm
SO ./assets/sprites/south.xpm
WE ./assets/sprites/west.xpm
EA ./assets/sprites/east.xpm

F 117,142,79
C 135,245,251

1111111111
10000000011
111100000101
10000000011
100N001001
1000001001
1000001001
1111111111
1